28 36
00 00 00 00 00 00 00 00 00 00 00 00 00 00 00 00 00 00 00 00 00 00 00 00 00 00 00 00
00 00 00 00 00 00 00 00 00 00 00 00 00 00 00 00 00 00 00 00 00 00 00 00 00 00 00 00
11 03 03 03 03 03 03 03 03 03 03 03 12 00 00 11 03 03 03 03 03 03 03 03 03 03 03 12
05 10 10 10 10 10 10 10 10 10 10 10 04 00 00 05 10 10 10 10 10 10 10 10 10 10 09 04
05 10 01 03 03 03 03 02 10 01 02 10 04 00 00 05 10 01 02 10 01 03 03 03 03 02 10 04
05 10 04 00 00 00 00 05 10 04 05 10 04 00 00 05 10 04 05 10 04 00 00 00 00 05 10 04
05 10 04 00 00 00 00 05 10 07 08 10 07 03 03 08 10 07 08 10 04 00 00 00 00 05 10 04
05 10 04 00 00 00 00 05 10 10 10 10 10 10 10 10 10 10 10 10 04 00 00 00 00 05 10 04
05 10 04 00 00 00 00 13 02 10 01 03 03 03 03 03 03 02 10 01 14 00 00 00 00 05 10 04
05 10 07 03 03 03 03 03 08 10 07 03 03 12 11 03 03 08 10 07 03 03 03 03 03 08 10 04
05 10 10 10 10 10 10 10 10 10 10 10 10 04 05 10 10 10 10 10 10 10 10 10 10 10 10 04
05 10 01 03 03 03 03 03 03 03 03 02 10 04 05 10 01 03 03 03 03 03 03 03 03 02 10 04
05 10 07 03 03 03 03 03 03 03 03 08 10 07 08 10 07 03 03 03 03 03 03 03 03 08 10 04
05 10 10 10 10 10 10 10 10 00 00 00 00 00 00 00 00 00 00 10 10 10 10 10 10 10 10 04
13 03 03 03 03 03 03 03 02 00 01 03 03 06 06 03 03 02 00 01 03 03 03 03 03 03 03 14
03 03 03 03 03 03 03 03 08 00 04 00 00 00 00 00 00 05 00 07 03 03 03 03 03 03 03 03
00 00 00 00 00 00 00 00 00 00 04 00 00 00 00 00 00 05 00 00 00 00 00 00 00 00 00 00
03 03 03 03 03 03 03 03 02 00 04 00 00 00 00 00 00 05 00 01 03 03 03 03 03 03 03 03
11 03 03 03 03 03 03 03 08 00 07 03 03 03 03 03 03 08 00 07 03 03 03 03 03 03 03 12
05 10 10 10 10 10 10 10 10 00 00 00 00 00 00 00 00 00 00 10 10 10 10 10 10 10 10 04
05 10 01 03 03 03 03 03 02 10 01 03 03 03 03 03 03 02 10 01 03 03 03 03 03 02 10 04
05 10 04 00 00 11 03 03 08 10 07 03 03 03 03 03 03 08 10 07 03 03 12 00 00 05 10 04
05 10 04 00 00 05 10 10 10 10 10 10 10 00 00 10 10 10 10 10 10 10 04 00 00 05 10 04
05 10 04 00 00 05 10 01 03 03 03 03 03 03 03 03 03 03 03 03 02 10 04 00 00 05 10 04
05 10 07 03 03 08 10 07 03 03 03 03 12 00 00 11 03 03 03 03 08 10 07 03 03 08 10 04
05 10 10 10 10 10 10 10 10 10 10 10 04 00 00 05 10 10 10 10 10 10 10 10 10 10 10 04
05 10 01 03 03 03 03 02 10 01 02 10 04 00 00 05 10 01 02 10 01 03 03 03 03 02 10 04
05 10 04 00 00 00 00 05 10 04 05 10 04 00 00 05 10 04 05 10 04 00 00 00 00 05 10 04
05 10 04 00 00 00 00 05 10 04 05 10 04 00 00 05 10 04 05 10 04 00 00 00 00 05 10 04
05 10 04 00 00 00 00 05 10 04 05 10 04 00 00 05 10 04 05 10 04 00 00 00 00 05 10 04
05 10 04 00 00 00 00 05 10 04 05 10 04 00 00 05 10 04 05 10 04 00 00 00 00 05 10 04
05 10 07 03 03 03 03 08 10 07 08 10 07 03 03 08 10 07 08 10 07 03 03 03 03 08 10 04
05 09 10 10 10 10 10 10 10 10 10 10 10 10 10 10 10 10 10 10 10 10 10 10 10 10 10 04
13 03 03 03 03 03 03 03 03 03 03 03 03 03 03 03 03 03 03 03 03 03 03 03 03 03 03 14
00 25 25 25 00 00 00 00 00 00 00 00 00 00 00 00 00 00 00 00 00 00 00 00 00 00 00 00
00 00 00 00 00 00 00 00 00 00 00 00 00 00 00 00 00 00 00 00 00 00 00 00 00 00 00 00
